11111111
1001001
10110C11
1C010C11
1100C011
11111111
