11111011
1E0100C1
10110C11
1C010C11
11P0C011
11111111
