11111011
100100C1
10110C11
1C010C11
1100C011
11111111
